%职位类型%
%部门类型%
%技术部门%
%网站应用%
%办公应用%
%服务应用%
%网络应用%
%主机名称%
%产品名称%
%应用名称%
%服务名称%
%设备类型%
%企业名称%
%企业域名%
%用户姓名%
%用户QQ%
%用户电话%
%用户编号%
